c8full	crazy eights / draw = 2 reverse = a skip = q
pig3	pig / x medium satan
rpsls	rock-paper-scissors / lizard-spock
test	blackjack / stake = 200 limit = 64 decks = 2 spam
bgm	backgammon
bts	battleships
blj	blackjack
caf	canfield
cnf	connect four
crp	craps
cze	crazy eights
crb	cribbage
frc	freecell
ftt	forty thieves
hmr	hamurabi
kld	klondike
ntn	ninety nine
rol	roulette
str	strategy
yat	yacht
wum	wumpus